################
#  gggg@gggg#  #
#  llll vvvv#XX#
#           #  #
#              #
#              #
#              #
#              #
#             G#
#    s         #
#              #
#              #
#              #
#              #
#C            C#
################
