################
#X#            #
# #            #
# #          # #
# #          # #
# #       oo # #
# #    @   o # #
# #          # #
# #          # #
# #          # #
# #          # #
# #          # #
# #          # #
# ############ #
#              #
################
