################
#X#            #
# #            #
# #      g   # #
# #      g   # #
# #      g o # #
# #    @   o # #
# #  v   l   # #
# #  v   l   # #
# #      l   # #
# #          # #
# #          # #
# #          # #
# ############ #
#              #
################
